NO  ./textures/n.xpm

SO                     ./textures/s.xpm

WE               ./textures/w.xpm
EA   ./textures/e.xpm

C         150,      184,          2

F          222,          174,            98

		1111111111111111111111111
		1000000000110000000000001
		1011000001110000002000001
		1001000000000000000000001
111111111011002001110000000000001
100000000011000001110111110111111
1111011111111111100000010001
11110111111111011101010010001
11000000110101011100000010001
1000000002000020000000012221
10000021000000001101010010001
1100000111000101111101111000111
11110111 1100001 101111010001
11111111 1101101 111111111011
		1110110111111111110111111
		1000000000110000000000001
		1011000001110000000000001
		1001000000000000000002001
111111111011000201110000000000001
100000000011000001110111110111111
11110111111111011100000010001
11110111111111011101010010001
11000000110101011100000010001
1000000000000021100000010021
100000000000000000000001N001
1100200111010101111101111000111
11100111 1110101 101111010001
11111111 1111111 111111111111