		111111 1111111111111111
		100001 11110000000000101
		101101   1110000001100001
		1001011111000000001100001
111111111011000001110000000000001
100000000011000001110111111111111
11110111111111011100000010001
   10111111111011101010010001
11110000110101011100000010001
10000001110000001100000010001
10000001 10000001111110010001
11110001 101010111  111110N0111
   10111 1110101   1111010001
11111111 1111111 111111111111